11111110
10C00001
1E0000P1
11111111
