11111111111111111111111
10000000000000000000001
10011100001110011100001
10000C000000000P0000001
1000000E000000000000001
11111100000000011110001
10100000000000000000001
101000000000C000E000001
11111111111111111111111