11111111
10C00001
1E0000P1
11111111
